1111111111111111111111111111111111
1E0000000000000C00000C000000000001
1010010100100000101001000N00010101
1010010010101010001001000000010101
100000000C00C0000000000000000000C1
1000011111111111110000011111101111
1110000011111000000001111111000111
1E0000000000000C00P00C000000000001
1010010100100000101001000000010101
1010010010101010001001000000010101
100000000C00C000000000000N000000C1
1111111111111111111111111111111111